WWWWWWWWWWWWWWWWWWWW
WP0WWWWWWWWWWWWWWWWW
WWC0WWWWWWWWWWWWWWWW
WWW00WWWWWWWWWWWWWWW
WWWW0CWWWWWWWWWWWWWW
WWWWW00WWWWWWWWWWWWW
WWWWWW000000000000WW
WWWWWWWWWWWWCWWCW0WW
WWE00000000WWWWWW0WW
WWWWWWWWWW00000000WW
WWWWWWWWWWWWWWWWWWWW
