1111111111111
1E000000000C1
1010011111001
1P11100000001
1111111111111