WWWWWWWWWWWWWWWWWWWW
WP00000000000CW0000W
W0000000W0000000000W
W000000WEW00000000CW
W000000000000000000W
W000000WCW000000000W
W0000000W0000000000W
W00000000000000000WW
W00000C00000000000WW
WW00000000000000000W
WWWWWWWWWWWWWWWWWWWW
